######################
#                    #
#                    #
#                    #
#                    #
#O    X   P          #
#                    #
#              O     #
#                    #
#        X           #
#                    #
#                    #
######################
